4700,0,3
4800,0,3
4900,0,3
5000,0,3
5100,0,3
5200,0,3
5300,0,3
5400,0,3
5432,0,3
5500,0,3
5600,0,3
4900,0,3
6700,0,3
6800,0,3
7100,0,3

